           '░░   ` `.¡,¡░░,¡,   '''░░░░░░░░░░░░░░░░░░░░░░░░░░░░░░░░░░░',¡░░░░░░░░░░░
           '░░      ¡░░░░░░░░`     '░'░░░░░░░░░░░░░░░░░░░░░░░░░░░░░'`└≡░░▒▒░▒░░░░░░░
    ▒      '░░     '░░░░░░░░░░░       ¡░░░░░░░░░░░░░░░░░░░░░░░░░░░   ¡░░░▒▒░▒░╖░░░░░
    ▒      '░░     :▒ '░░░░░░░'          ' ' ' ' ''░'' ' ' ' '     '¡░░g░▒▒░▒░░░░░░░
    ▒      '░▒     :░   '░░░░░' `                      `   ` `     '░░▒▒▒▒▒▒▒░▒░░░░░
    ▒      '░▓     :░   '░░░░░¡,`                                 .╥▒███▒▒▒▒▒▒@▒▒░░░
    ▒      '░▓     └▓   '░░░░'░░`                                  ░░▒▒█▓█▒@▒▒▒▒░░░░
    ▒      '░▓     └▓   '░░░░  '                                  ,░▒██▒███▒▒▒▒▒▒▒░░
    ▒      '░▓     └▓   '░░░░  '                                  ░░░▀██▓▀▒▒▒▒╫▒▒▒░░
    ▒      '░▓     └▓   :░░░░  '  '                              .░░▒▒▒░▒▒▒╜▒▒▒▒░░░░
    ▒      '░▓     └▓   '░░░░  ¡  '                              .¡'▒░▒░╙░░╓▒▒▒▒░░░░
    ▒      '░▓     └▓   '░░░░  ░  ¡  '                            ¡`,░▒░░`╓░▒░╫▒▒░░░
    ▒      '░▓     └▓   '░░░░  ╟  ░  '                            ░░░░▒@∩▒▒░▒▒▒▒▒░░░
    ▒      '░▓     └▓   '░░░░  ╟  ╫  ░                            ¡,░▒▒▒░░░░▒▒▒░░░░░
    ▒      '░▓     └▓   '░░░░  ╟  ░  '                            ░░░░▒▒░▒▒░▒'░▒░░░░
    ▒      '░▓     └▓   '░░░░  ╟     '                              ░▒▒▒╜░▒▒▒▒▒▒░░░░
    ▒      '░▓     └▓   :░░░░  ╙  '  '                              ░`░▒;▒░▒▒░▒▒░░░░
    ▒      '░▓     └▓   '░░░░  ░  '  '                              ░'░╜░╜░╜░:░░░░░░
    ▒      '░▓     └▓   '░░░░  ░  '  '                              , ;░ ░░░░'░░░░░░
    ▒      '░▓     └▓   '░░░░  ░  '  '                              ''░░ '░░░'░░░░░░
    ▒      '░▓     └▓   '░░░░  ░  '  '                                ,, `.''`└`.`.¡
    ▒      '░▓     └▓   '░░░░  '  '  '                                ''`░░░░ ░░░░≡░
    ▒      '░▓     ┌▓   '░░░░  '  '  '                              '    ,','░░░░░░░
    ▒      '░▒     :░   '░░░░  '  ░░                                     └*░░,░░' ¡
    ▒      '░░     :░   '░░░░╖╖╖▒▒░░░                                 ".  ░,' ░░░¡,.
    ▒      '░░     :▒,, ¡░░░░▒▒▒▒▒░'`                                    ¡░   ░░░░░░
    ▒      '░▒  .,░░▒▒▒▒░░░░░▒╜░'       . . ¡,,,,░,,¡,¡,,,,,,¡,,  .        '`    . .
    ░       "▒▒▒▒▒▒▒▒▒▒▒░░░░░ ,¡░¡░¡;░░¡░░░░░░░░░░░░░░░░░░░░░░░░░░░░░         '░
    ░    ¡░░░░▒▒▒▒▒▒▒▒╜`░░░░░░░░░░░░░░░░░░░░░▒░▒░░░▒░▒░▒░▒░▒░▒░░░▒░░░░¡    ²   '░░░
      :░░░░░░░░▒▒▒╜╜'.░░░░░░░░░░░░░░░▒░▒▒▒▒▒▒▒▒▒▒▒▒▒▒▒▒▒▒▒▒▒▒▒▒▒▒▒░▒░░░░╓. `   ` `